0 0 0 0 0 0 0 0 0 0 0 0 0 0 0 0 0 0 0 0 0 0 0 0 0 0 0 0 0 0 0 0 0 0 0 0 0 0 0 0 0 0 0 0 0 0 0 0 0 0 
0 7 7 7 7 7 7 7 7 7 7 7 7 7 7 7 0 1 1 1 1 1 1 1 1 1 1 0 0 0 0 0 6 6 6 6 6 6 6 6 6 6 6 6 6 6 7 7 7 0 
0 7 7 7 7 7 7 7 7 7 7 7 7 7 7 7 0 1 1 1 1 1 1 1 1 1 1 1 1 1 1 0 6 0 0 0 0 0 0 0 0 6 6 6 6 7 7 7 7 0 
0 7 7 13 13 13 13 13 13 13 13 13 13 7 7 7 0 1 1 1 1 1 1 1 1 1 1 1 1 1 1 0 6 0 6 6 6 6 6 6 6 6 6 6 7 7 7 7 7 0 
0 7 7 13 13 13 13 13 13 13 13 13 13 13 7 7 0 1 1 1 1 1 1 1 1 1 1 1 1 1 1 0 6 0 6 6 6 6 6 6 6 6 6 6 7 7 7 7 7 0 
0 7 7 13 13 13 13 13 13 13 13 13 13 13 7 7 0 1 1 1 1 1 1 1 1 0 0 0 0 0 0 0 6 0 0 6 6 6 6 6 6 6 6 6 7 7 7 7 7 0 
0 7 7 7 7 7 7 7 13 13 13 13 13 7 7 7 0 1 1 1 1 1 1 1 1 1 1 1 1 1 1 6 6 6 6 6 6 6 6 6 6 6 6 7 7 7 7 7 7 0 
0 7 7 7 7 7 7 7 7 13 13 13 13 7 7 7 7 1 1 1 1 1 1 1 1 1 1 1 1 1 1 0 6 6 6 6 6 6 6 6 6 6 7 7 7 7 7 7 7 0 
0 7 7 7 7 7 7 7 7 7 7 7 7 7 7 7 0 1 1 1 0 1 1 1 1 0 1 1 1 1 1 0 0 0 0 0 0 0 0 0 0 0 0 0 0 0 10 0 0 0 
0 7 7 7 7 7 7 7 7 7 7 7 7 7 7 7 0 1 1 1 0 1 1 1 1 0 1 1 1 1 1 0 10 10 10 10 10 10 10 10 10 10 10 10 10 10 10 10 10 0 
0 7 7 7 7 7 7 7 7 7 7 7 7 7 7 7 0 1 1 1 0 1 1 1 1 0 0 1 1 1 1 0 10 10 10 10 10 10 10 10 10 10 10 10 10 10 10 10 10 0 
0 0 0 7 7 7 7 7 7 7 7 7 7 7 7 7 0 0 0 0 0 0 0 0 0 0 0 0 0 0 0 0 10 10 10 10 10 10 10 10 10 10 10 10 10 10 10 10 10 0 
0 14 0 0 0 0 0 0 0 0 0 0 0 0 0 0 0 2 2 2 2 0 2 2 2 2 2 2 2 2 2 0 10 10 10 10 10 10 10 10 10 10 10 10 10 10 10 10 10 0 
0 14 14 14 0 14 14 14 14 14 14 14 0 14 14 14 0 2 2 2 2 0 2 2 2 2 2 2 2 2 2 0 0 0 0 0 0 0 0 0 0 0 0 0 0 0 10 10 10 0 
0 14 14 14 0 14 14 14 14 14 14 14 0 14 14 14 0 2 2 2 2 0 2 2 2 2 2 2 2 2 2 0 10 10 10 10 10 10 10 10 10 10 10 10 10 10 10 10 10 0 
0 14 14 14 0 14 14 14 14 14 14 14 0 14 14 14 0 2 2 2 2 0 2 2 2 0 2 2 2 2 2 10 10 10 10 10 10 10 10 10 10 10 10 10 10 10 10 10 10 0 
0 14 14 14 14 14 14 14 0 14 14 14 0 14 14 14 2 2 2 2 2 0 2 2 2 0 2 2 2 2 2 0 10 10 10 10 10 10 10 10 10 10 10 10 10 10 10 10 10 0 
0 14 14 14 14 14 14 14 0 14 14 14 14 14 14 14 0 2 2 2 2 0 2 2 2 0 0 0 0 0 0 0 0 0 0 0 0 0 0 0 0 0 0 0 0 0 0 0 0 0 
0 14 14 14 14 14 14 14 0 14 14 14 14 14 14 14 0 2 2 2 2 0 2 2 2 2 2 2 2 2 2 0 4 4 4 4 4 4 4 4 4 4 4 4 4 4 4 4 4 0 
0 14 14 14 14 14 14 14 0 14 14 14 14 14 14 14 0 2 2 2 2 0 2 2 2 2 2 2 2 2 2 0 4 4 4 4 4 4 4 4 4 4 4 4 4 4 4 4 4 0 
0 0 0 14 0 0 0 0 0 0 0 0 0 0 0 0 0 2 2 2 2 2 2 2 2 2 2 2 2 2 2 0 4 4 4 0 0 0 0 0 0 0 0 0 0 0 4 4 4 0 
13 8 8 8 8 8 8 8 8 8 8 8 8 8 8 8 0 2 2 2 2 2 2 2 2 2 2 2 2 2 2 0 4 4 4 0 4 4 4 4 4 4 4 4 4 4 4 4 4 0 
13 8 8 8 8 8 8 8 8 8 8 8 8 8 8 8 0 0 0 0 0 0 0 0 0 0 0 0 0 0 0 0 4 4 4 0 4 4 4 4 4 4 4 4 4 4 4 4 4 0 
13 8 8 8 0 0 0 0 0 0 0 0 0 8 8 8 0 11 11 11 11 11 11 11 11 11 11 11 11 11 11 0 4 4 4 0 4 4 4 4 4 4 4 4 4 4 4 0 0 0 
13 8 8 8 0 8 8 8 8 8 8 8 8 8 8 8 0 11 11 11 11 11 11 11 11 11 11 11 11 11 11 0 4 4 4 0 4 4 4 4 4 0 4 4 0 0 0 0 4 0 
13 8 8 8 0 8 8 8 8 8 8 8 8 8 8 8 0 11 11 11 0 11 11 0 11 11 0 11 11 11 11 0 4 4 4 0 4 4 4 4 4 0 4 4 4 4 4 4 4 0 
13 8 8 8 0 8 8 8 8 8 8 8 8 8 8 8 0 11 11 11 0 11 11 0 11 11 0 11 11 11 11 0 4 4 4 0 4 4 4 4 4 0 4 4 4 4 4 4 4 0 
13 8 8 8 0 0 0 0 0 0 0 0 0 0 0 0 0 11 11 11 0 11 11 0 11 11 0 11 11 11 11 0 4 4 4 0 0 4 4 4 4 0 4 4 4 4 4 4 4 0 
13 8 8 8 8 8 8 8 8 8 8 8 8 8 8 8 0 11 11 11 0 11 11 0 11 11 0 11 11 11 11 11 4 4 4 4 0 4 4 4 4 0 0 0 0 0 0 0 0 0 
13 8 8 8 8 8 8 8 8 8 8 8 8 8 8 8 11 11 11 11 11 11 11 11 11 11 11 11 11 11 11 0 4 4 4 4 0 4 4 4 4 4 4 4 4 4 4 4 4 0 
13 8 8 8 8 8 8 8 8 8 8 8 8 8 8 8 0 11 11 11 11 11 11 11 11 11 11 11 11 11 11 0 4 4 4 4 0 4 4 4 4 4 4 4 4 4 4 4 4 0 
13 8 8 8 8 8 8 8 8 8 8 8 8 0 0 0 0 0 0 0 0 0 0 0 0 0 0 0 0 0 0 0 0 0 4 0 0 0 0 0 0 0 0 0 0 0 0 0 0 0 
0 0 0 0 0 0 0 0 0 0 0 0 0 0 17 17 17 17 17 17 17 17 17 17 17 17 17 17 17 17 17 17 17 17 17 17 0 15 15 15 15 15 15 15 15 15 15 15 15 0 
0 9 9 9 9 9 9 9 9 9 9 9 9 0 17 17 17 17 17 17 17 17 17 17 17 17 17 17 17 17 17 17 17 17 17 17 0 15 15 15 15 15 15 15 15 15 15 15 15 0 
0 9 9 9 9 9 9 9 9 9 9 9 9 0 17 17 17 17 17 17 17 0 17 17 17 17 17 17 0 0 17 17 17 17 17 17 0 15 15 15 15 15 15 15 15 0 0 15 15 0 
0 9 9 0 0 0 0 0 9 9 9 9 9 0 17 17 0 17 17 17 17 0 0 17 17 17 17 17 17 0 0 17 17 17 17 17 0 15 15 15 15 15 15 15 15 0 0 15 15 0 
0 9 9 0 9 9 9 9 9 9 0 0 0 0 17 17 0 0 17 17 17 17 0 0 0 17 17 17 17 17 0 0 17 17 17 17 0 15 15 15 15 15 0 15 15 15 15 15 15 0 
0 9 9 0 0 9 9 9 9 9 0 9 9 0 17 17 17 0 17 17 17 17 17 17 0 17 17 17 17 17 17 0 0 0 17 17 0 15 15 15 15 15 0 15 15 15 15 15 15 0 
0 9 9 9 0 0 0 0 0 0 0 9 9 17 17 17 17 0 0 17 17 17 17 17 0 0 17 17 17 17 17 17 17 0 17 17 0 15 15 15 15 15 0 15 15 15 15 15 15 0 
0 9 9 9 9 9 9 9 9 9 9 9 9 0 17 17 17 17 0 0 17 17 17 17 17 0 0 17 17 17 17 17 17 0 0 17 0 15 15 15 15 15 0 15 15 0 0 15 15 0 
0 9 9 9 9 9 9 9 9 9 9 9 9 0 17 17 17 17 17 0 0 17 17 17 17 17 0 0 0 17 17 17 17 17 0 0 0 15 15 15 15 15 0 15 15 0 0 15 15 0 
0 0 9 0 0 0 0 0 0 0 0 0 0 0 0 0 0 0 0 0 0 0 0 0 0 0 0 0 0 0 0 0 0 0 0 0 0 0 3 0 0 0 0 15 15 15 15 15 15 0 
0 12 12 12 12 12 12 12 12 12 12 12 12 0 16 16 16 16 16 16 16 16 16 16 16 16 16 0 3 3 3 3 3 3 0 3 3 3 3 3 3 3 0 15 15 15 15 15 15 0 
0 12 12 12 12 12 12 12 12 12 12 12 12 0 16 16 16 16 16 16 16 16 16 16 16 16 16 0 3 3 3 3 3 3 0 3 3 3 3 3 3 3 0 15 15 15 15 15 15 0 
0 12 0 0 0 0 0 0 0 0 0 0 12 0 16 16 0 0 16 16 16 0 0 0 0 16 16 0 3 3 3 3 3 3 0 3 3 3 3 3 3 3 0 15 15 0 0 15 15 0 
0 12 12 12 12 12 12 12 12 12 12 12 12 12 16 16 0 16 16 16 16 16 16 16 0 16 16 16 3 3 3 3 3 3 3 3 3 3 3 3 3 3 0 15 15 0 0 15 15 0 
0 12 12 12 12 12 12 12 12 12 12 12 12 0 16 16 0 16 16 16 16 16 16 16 0 16 16 0 3 3 3 3 3 3 3 3 3 3 3 3 3 3 0 15 15 15 15 15 15 0 
0 12 0 0 0 0 12 12 12 12 12 12 12 0 16 16 0 0 0 0 0 0 0 0 0 16 16 0 3 3 3 3 3 3 3 3 3 0 3 3 3 3 0 15 15 15 15 15 15 0 
0 12 12 12 12 12 12 12 12 12 12 12 12 0 16 16 16 16 16 16 16 16 16 16 16 16 16 0 3 3 3 3 3 3 3 3 3 0 3 3 3 3 0 15 15 15 15 15 15 0 
0 0 0 0 0 0 0 0 0 0 0 0 0 0 0 0 0 0 0 0 0 0 0 0 0 0 0 0 0 0 0 0 0 0 0 0 0 0 0 0 0 0 0 0 0 0 0 0 0 0 